1111111111111111111
1P000000000000C0001
1000C000C0000000001
1000111001110011101
1000001000E10000101
1000111001110011101
1000C010000100C0101
1000111001110011101
10000000000000000C1
10000C0000000000001
10000000C0000000001
1111111111111111111