1111111111111111111111111
1000000000000000000000001
1000C00001000000000000001
1000000000000000000100001
1000000000000000000000001
100000001000E000000000001
10000000000000000C0000001
1000000000000100000000001
1000C00000000000000000001
1001000000010000000000001
100000P000000C00000000001
1000000000000000000100001
1000100000000000000000001
10000000000000000C0000001
1111111111111111111111111