1111111111111
1C01P1E101C11
1000111011011
1111111111111