1111111111111
1C01P0E101C11
1CC0011010111
1111111111111