1111111111111
1111111P11111
1111111E00111
1111111110C11
1111111111111