1111111111111
10010000000C1
10X0011X11001
1P001X0X0E001
1111111111111