1111111111111111111111111111111111
1E0000X00000000C0X000C0000X0000001
101001010010000010100100X000010101
1010X10010101010001001000000010101
1P0000000C00C00000X000000X000000C1
1111111111111111111111111111111111