1111111111111111111111111
10X0P0000000C000000000001
1011111110111111111111101
1010000010000000000000101
1C1011101X111110111110101
101010101010C010100010101
1010101E10111010101110101
10101010100010101X0000101
1010111011111010111110101
101000X000000000000000101
1011111111111011111111101
100C0000000000000000X0001
1011111110111111111111101
101000001000000000C000101
1010111010111110111110101
10101X1010100010100010101
1010101010111010101110101
1010101010001010100X00101
1010111011111010111110101
100000000000000000C000001
1111111111111111111111111