1111111111111111111111111111111111
1E0000000000000C00000C00000000X001
10100101001X0000101001000000010101
1010010X10101010001001000000010101
1P000X000C00C000000000X000000000C1
1111111111111111111111111111111111