11111111111111111111111111111111111111111111
1P000000C0000000X000000000000C000X00000C0001
10111100011111001111100111110011111001111001
10111100011111001111100111110011111001111001
10111100011111001111100111110011111001111001
10111100011111001111100111110011111001111001
1X11110X01111100111110011111X011111001111001
10111100011111001111100111110011111001111001
10111100011111001111100111110011111001111001
10000000C00000000000C00000000C000000000C0001
10111111111111111111111111111111111111111101
1000000000000000000000000000000000X000000001
111111111111111111111E1111111111111111111111
10000C00000000C0000000000C0000000000C0000001
10111100111110011111001111100111110011111001
10111100111110011111001111100111110011111001
10111100111110011111001111100111110011111001
10111100111110011111001111100111110011111001
101111X0111110011111001111100111110011111001
10111100111110011111001111100111110011111001
10000000000000000000C00000000000000000000001
10111111111111111111111111111111111111111101
1000000C000X000000000000C0000000000000000001
11111111111111111111111111111111111111111111