1111111111111111111111111
1000P0000000C000000000011
1011111110111111111111101
1010000010000000000000101
1C10111010111110111110101
101010101010C010100010101
1010101E10111010101110101
1010101010001010100000101
1010111011111010111110101
1010000000000000000000101
1011111111111011111111101
100C000000000000000000001
1011111110111111111111101
101000001000000000C000101
1010111010111110111110101
1010101010100010100010101
1010101010111010101110101
1010101010001010100000101
1010111011111010111110101
100000000000000000C000001
1111111111111111111111111