11111111111111111111111111111111111111111111
1P000000C00000000000000000000C000000000C0001
10111100011111001111100111110011111001111001
101111X0011111001111100111110011111X01111001
10111100011111001111100111110011111001111001
101111000111110X1111100111110011111001111001
10111100011111001111100111110011111001111X01
1011110001111100111110011111X011111001111001
10111100011111001111100111110011111001111001
10000000C0000X000000C00000000C000000000C0001
10111111111111111111111111111111111111111101
100000000000000000000000000000000X0000000001
111111111111111111111E1111111111111111111111
10000C00X00000C0000000000C0000000000C0000001
10111100111110011111001111100111110011111001
10111100111110011111001111100111110011111001
1011110011111X0111110011111X0111110011111001
10111100111110011111001111100111110011111001
10111100111110011111001111100111110011111001
10111100111110011111001111100111110011111001
10000000000000000000C0000000000000X000000001
10111111111111111111111111111111111111111101
1000000C0000000000000000C0000000000X00000001
11111111111111111111111111111111111111111111